width=20
height=20
####################
#..................#
#..................#
#..............I...#
#..................#
#.....##############
#..................#
#.............I....#
#..................#
#.........P..M.....#
#..................#
#..................#
#....##......##....#
#..................#
#..................#
#..................#
#........N.........#
#..................#
#..................#
####################