width=20
height=20
####################
#..................#
#..................#
#..................#
#..................#
#.....##############
#..................#
#............I.....#
#..................#
#.........P........#
#..................#
#..................#
#....####..####....#
#.......#..........#
#.......#..........#
#..................#
#..................#
#..................#
#..................#
####################