width=20
height=20
####################
#..................#
#..................#
#..................#
#..................#
#.....#......#.....#
#..................#
#..................#
#..................#
#.........P........#
#..................#
#..................#
#.....#......#.....#
#..................#
#..................#
#..................#
#..................#
#..................#
#..................#
####################