width=20
height=20
####################
#..................#
#..I...............#
#..............I...#
#..................#
#.....##############
#..................#
#............II....#
#..................#
#.........P........#
#..................#
#..................#
#....####..####....#
#.......#..........#
#.......#..........#
#.............I....#
#..................#
#...I..............#
#..................#
####################