width=20
height=20
####################
#..................#
#..M...............#
#..................#
#..................#
#..................#
#..................#
#.............I....#
#..................#
#....M....P........#
#..................#
#######.....########
#..................#
#..................#
#..................#
#..................#
#..................#
#..................#
#..................#
####################